####################
#..P........H......#
#....H.........H...#
#..####.......####.E
#..............H...#
#..H...............#
####################
