#####################################
#P#.............#........k..........#
#.#####.##.##.#k#.#.###.#.###.#####.#
#...#...#.....#...#...#.#.....#...#.#
###.#.###.#####.#####.###.#####.#.#.#
#...#.#...#.....#...#.........#.#.#.#
#.###.###.#.#####.###.###.#####.#.#.#
#.#.........#.........#.#.......#...#
#.#.###.#####.#####.#.#.#.#########.#
#...#.....#.....#...#...#.k.......#.#
#.#.#.###.##..###.###.#.###.#.#####.#
#.#.#.#.#.#.......#.#.#.....#.......#
#.#.#.#.#.#k#######.#.#.#####.####.##
#.#...#.#...#.............#.........#
#.#####.#####.###.#.#####.#########.#
#...#.........#...#.........#.......#
###.###.###..##########.###.###.#####
#.#...#...#...........#.#.....#.....#
#.###.#####.####.##.#.#.#.###.#####.#
#...#.#...#...#.....#.....#...#...#.#
#.#.#.#.#.#.#.#.#########.#.#####.#.#
#...#...#.#.............#k..#.....#.#
#.#.#####.###.######..#.#.#.#...###.#
#.#......k..#.....#...#.......#....E#
#.#####.###.#####.#.#.#####.#.##.####
#...#...#.#...#.....#.#.....#.#.....#
#.#.###.#.###.#.#####.#.#.###.#####.#
#.#...#.....#...#.....#.....#.......#
#.###.#####.#####.#########.#..####.#
#...#.#.....#.....#.......#.....#...#
###...##.#.##.#.###.#.###.#.###.###.#
#...#.#...k.#.#.....#.#...#...#...#.#
#.#.#.#.#.#.#.#######.#.#.##..###.###
#.#.#.#.#.#...#.......#...#.........#
#k#.#.#...#####.####E####.#####.###.#
#...#...........#..................A#
#####################################
