#####################
#P#.....#E....#.....#
#.#.#.###.#.#.#.#.#.#
#.#.#.....#.#.#.#k#.#
#.###.#####...#.#.#.#
#...#.#.....#.#.#...#
###.###.#####.#####.#
#.#.#...#...........#
#...#.###########.#.#
#.#.#....k..#...#...#
#k#.#######.#.#.#####
#.#...#...#.#.#.....#
#.###.#.#.#.#.#####.#
#...#...#.#...#...#.#
###.#####.###.#.#.#.#
#.......#...#...#.#.#
#.#.###.###.#.###.#.#
#.#.......#.#...#.#.#
#.#..##.###.#.#.###.#
#.....#.......#....A#
#####################
