#########################
#P........#k..#....E#...#
#.#####.#.#.#.#.###.#.#.#
#...........#...#.....#.#
#.#.###.###.#####.###.#.#
#.....#...#.#.........#.#
#.###.###.#.#.##.####E#.#
#...#...#...#.....#.....#
#######.###.###.#.#.###.#
#k....#.....#...#.......#
#.###.#.#####.#.#####.#.#
#.......#.....#.......#.#
#.#.##..#.#######.#.###.#
#...#...#.#.....#.#.#...#
#.#.#####.#.#.###...#.###
#.#...#...#.#.#.k.#.#...#
#####.#.###.###.###.###.#
#...........#...#...#...#
#.###.####..#.#.#.###.###
#...#.#.......#.#...#...#
##.....k#####.#.###.###.#
#...#...#...#.#.#...#...#
#.#.#.#.###.#.###.#.#.#k#
#...........#.........#A#
#########################
